11111111111
1CCCCPCCCC1
1CCCCCCCCC1
1CCCCCCCCC1
1CCCCCCCCC1
1CCCCECCCC1
1CCCCCCCCC1
1CCCCCCCCC1
1CCCCCCCCC1
1CCCCCCCCC1
11111111111