1111111111111111111111111111111111111111
1000000000000000000001100110011001100101
1110011111111111111000000000000000000001
10000000C0000000001110011001100110011001
1111111111111001111000000000000000000001
1000000000000000001001100110011001100101
1001100110011001101000000000000000000001
1000000000000000001110011001100110011001
1110011001100110011000000000000000000001
1000000000000000001001100110011001100101
1111111111110111111000000000000000000001
1000000000010000001110011001100110011001
1011111111010000001000000000000000000001
1010000001010000101001100110011001100101
1010111101010000001000000000000000000101
10101C0001011111111110011001100110011001
1010111111011000001000000000000000000001
1010000000011000001001100110011001100011
1011111111110000P00000000000000000000001
1000000000000011111E00011001100110011001
1111111111111111111111111111111111111111