1111111
1111111
1111111
11CPE11
1111111
1111111
1111111