1111111111111111111111111111111111111111
1P00000000000000000CE00000C0000000000001
10000000000000C00CC000C00000000000000001
10000000000000000000C0000000000000000001
1000000000000000011011000000000000000001
1000000000000001100000110000000000000001
1000000000000011000000011000000000000001
1000000000000010000000001000000000000001
1000000000000010000000001000000000000001
1000000000000010000000001000000000000001
1000000000000010000000001000000000000001
1000000000000010000000001000000000000001
1000000000000010000000001000000000000001
1000000000000010000000001000000000000001
1000000000000010000000001000000000000001
1000000011100010000000001000000000000001
1000010000001010000000001111111100000001
1000100000000110000000001100000010000001
1000010000000110000000001100000010000001
1000001000000000000000000000000110000001
1111111111111111111111111111111111111111