1111111111111111111111111111
10000000000000000000P0000001
1110011111111111111111110011
10000000C00000000000C0000001
1111111111111001111111111111
1000000000000000000000000001
1001111111110011111111111111
1000000000000000000000000001
1111111111111100111111111001
100000000C0000000C0000000001
1001111111111111111111111111
1000000000000000000000000001
1000000000000000000000000001
1000000000000000000000000001
1000000000000000000000000001
1000000000000000000000000001
1E00000000000000000000000001
1111111111111111111111111111