11111111111111111111111111111111111111111
10000000000000000000011001100111001100101
11100111111111111110000000000010000000001
10000000C00000000011100110011001110011001
11111111111110011110000000000000100000001
10000000000000000010011001100110011100101
10011001100110011010000000000000001000001
10000000000000000011100110011001100111001
11100110011001100110100000000000000010001
10000000000000000010011100110011001100101
11111111111101111110001000000000000000001
10000000000100000011100111001100110011001
10000000000100000011100111001100110011001
10111111110100000010000010000000000000001
10100000010100001010011001110011001100101
10101111010100000010000000100000000000101
10101C00010111111111100110011100110011001
10101111110110000010000000001000000000001
10100000000110000010011001100111001100011
1011111111110000P000000000000010000000001
1000000000000011111E000110011001110011001
11111111111111111111111111111111111111111